You are a princess that has been captured by the demon lord for who knows what purpose. Your kingdom's valiant knights have made several attempts to rescue you but none have succeeded. It's time to take matters into your own hands.

damsel in distress?
An Interactive Fiction by Brycen Tanaka the release number is 1 the story creation year is 2017 The story headline is "A semi typical princess story"
Release 1 / Serial number 170227 / Inform 7 build 6M62 (I6/v6.33 lib 6/12N) SD

prison cell
a dank and musty prison cell. there isn't much to do but look at the scratches on the wall and talk to the guard that's even more bored than you. the rest of the dungeon is to the east

>ask about grilled cheese
You can't see any such thing.

>ask guard about grilled cheese
I just love grilled cheese, how about you?

>yes
"even better than a fellow sandwich lover, a fellow grilled cheese lover! lets get you out of there so we can hold an actual conversation. heres the key" he says, almost jumping with joy

>ask guard about sandwiches
I just love sandwiches, how about you?

>yes
it's so good to meet a fellow sandwich lover. my favorite is grilled cheese.

>unlock door
(with prison key)
You unlock your cell door.

>open
(prison key)
It isn't something you can open.

>open door
You open your cell door.

>e
dungeon
It is somehow even smellier here than inside your cell. it turns out that the dungeon is actually really small and plain. now that you're getting a better look, there is only one other cell besides yours. the only thing you can see is your guard looking quite happy. "what do you want to talk about, friend?" he asks almost jumping with joy. your cell is to the west, the other cell is to the east, and there is another exit to the north.

>n
warden's room
what appears to be a typical office space. there is a desk piled high with papers and not much else.

>w
west hallway
a plain hallway connecting the prison to the rest of the castle. the kitchen is to the north and the warden's room is to the east

>n
kitchen
you can see several ghosts here, all making sandwiches. they must really like their sandwiches. there is a cabinet and several tables here as well. the hallway is to the south and the courtyard is to the east

>open cabinet
You open cabinet, revealing bread, cheese, lettuce, garlic, peanut butter and jelly.

>take all
bread: Taken.
cheese: Taken.
lettuce: Taken.
garlic: Taken.
peanut butter: Taken.
jelly: Taken.

>give bread to ghost chef
he takes your ingredient and gets back to work

>x ghost chef
a spectral chef. similar to how the skelletons somehow move without muscle, he inexpilcably makes sandwiches without physicalf form.

>s
west hallway
a plain hallway connecting the prison to the rest of the castle. the kitchen is to the north and the warden's room is to the east

>s
You can't go that way.

>e
warden's room
what appears to be a typical office space. there is a desk piled high with papers and not much else.

>s
dungeon
It is somehow even smellier here than inside your cell. it turns out that the dungeon is actually really small and plain. now that you're getting a better look, there is only one other cell besides yours. the only thing you can see is your guard looking quite happy. "what do you want to talk about, friend?" he asks almost jumping with joy. your cell is to the west, the other cell is to the east, and there is another exit to the north.

>ask guard for norbert's key
"okay, here's the key" he says

>ask guard2 for norbert's key
"okay, here's the key" he says

>ask guard about notbert's key
he doesn't seem comfortable talking about that. you should try changing the subject.

>ask guard about other cell
He just shrugs and says, "we have to keep our supply up, demon lords orders."

* * *

>yes
"even better than a fellow sandwich lover, a fellow grilled cheese lover! lets get you out of there so we can hold an actual conversation. heres the key" he says, almost jumping with joy

>i
You are carrying:
  prison key

>e
You can't go that way.

>e
You can't go that way.

>w
You can't go that way.

>a
That's not a verb I recognise.

>s
You can't go that way.

>n
You can't go that way.

>unlock cell
(with prison key)
You unlock celldoor.

>e
You can't go that way.

* * *

>w
You can't go that way.

>e
You can't go that way.

>open cell
You open celldoor.

>e
You can't go that way.

>east
You can't go that way.

* * *

>yes
"even better than a fellow sandwich lover, a fellow grilled cheese lover! lets get you out of there so we can hold an actual conversation. heres the key" he says, almost jumping with joy

>open door
It seems to be locked.

>unlock door
(with prison key)
You unlock your cell door.

>open door
You open your cell door.

* * *

>e
dungeon
It is somehow even smellier here than inside your cell. it turns out that the dungeon is actually really small and plain. now that you're getting a better look, there is only one other cell besides yours. the only thing you can see is your guard looking quite happy. "what do you want to talk about, friend?" he asks almost jumping with joy. your cell is to the west, the other cell is to the east, and there is another exit to the north.

>ask guard for norbert's key
"okay, here's the key" he says

>e
(first opening the other cell door)
It seems to be locked.

>unlock norbert's door
What do you want to unlock the other cell door with?

>drop key
Dropped.

>unlock norbert's door
(with prison key)
That doesn't seem to fit the lock.

>take
(norbert's key)
Taken.

>unlock door
What do you want to unlock your cell door with?

>unlock norbert's door
What do you want to unlock the other cell door with?

>norbert's key
You unlock the other cell door.

>i
You are carrying:
  norbert's key
  prison key

>unlock norbert's door
What do you want to unlock the other cell door with?

>norbert's key
That's unlocked at the moment.

>e
(first opening the other cell door)

norbert's cell
this cell looks exactly the same as your cell, except without scratches and your cell didn't have what looks like a dirty monkey.

>ask norbert about burgers
he rolls over to show you a burger patty

>ask norbert about burgers
he rolls over to show you a burger patty

>ask norbert about guard
he mumbles something about lonely and dumb.

>take
(the other cell door)
That's hardly portable.

>take burger
You can't see any such thing.

>e
You can't go that way.

>s
You can't go that way.

>w
dungeon
It is somehow even smellier here than inside your cell. it turns out that the dungeon is actually really small and plain. now that you're getting a better look, there is only one other cell besides yours. the only thing you can see is your guard looking quite happy. "what do you want to talk about, friend?" he asks almost jumping with joy. your cell is to the west, the other cell is to the east, and there is another exit to the north.

>n
warden's room
what appears to be a typical office space. there is a desk piled high with papers and not much else.

>e
east hallway
a plain hallway adorned with pictures connecting the prison to the rest of the castle. the armory is to the north and the warden's room is to the west

>n
armory
The place where the monsters store their weapons. you can see an assortment of swords, spears, and axes. the courtyard is to the west.

>take all
There are none at all available!

>e
You can't go that way.

>w
courtyard
a large open area in front of the throne room. you can see kobolds swinging their swords at wooden practice dummy. there is one still available if you'd like to practice too. the throne room is to the north.

>w
kitchen
you can see several ghosts here, all making sandwiches. they must really like their sandwiches. there is a cabinet and several tables here as well. the hallway is to the south and the courtyard is to the east

>open cabinet
You open cabinet, revealing bread, cheese, lettuce, garlic, peanut butter and jelly.

* * *

>take all
bread: Taken.
cheese: Taken.
lettuce: Taken.
garlic: Taken.
peanut butter: Taken.
jelly: Taken.

>give burger to chef
Which do you mean, garlic burger, cheese burger, peanut butter burger, jelly burger or veggie burger?

>give bread to ghost
he takes your ingredient and gets back to work

>ask for burger
You can't see any such thing.

>ask ghost for burger
Which do you mean, garlic burger, cheese burger, peanut butter burger, jelly burger or veggie burger?

>ask ghost about burger
he listens to what you have to say, then turns back to his work.

>i
You are carrying:
  jelly
  peanut butter
  garlic
  lettuce
  cheese
  norbert's key
  prison key

>ask ghost about sandwich
i make them for a living! bring me the ingredients and i'll make any kind of sandwich you want!

>ask ghost chef for burger
Which do you mean, garlic burger, cheese burger, peanut butter burger, jelly burger or veggie burger?

>burger
Which do you mean, garlic burger, cheese burger, peanut butter burger, jelly burger or veggie burger?

>just burger
You can't see any such thing.

>ask ghost for burger
Which do you mean, garlic burger, cheese burger, peanut butter burger, jelly burger or veggie burger?

>garlic
Ghost chef has better things to do.

>ask ghost chef for burger
Which do you mean, garlic burger, cheese burger, peanut butter burger, jelly burger or veggie burger?

>garlic burger
Ghost chef has better things to do.

* * *

>i
You are carrying:
  jelly
  peanut butter
  garlic
  lettuce
  cheese
  norbert's key
  prison key

* * *

I beg your pardon?

>x ghost chef
You see nothing special about ghost chef.

* * *

>yes
"even better than a fellow sandwich lover, a fellow grilled cheese lover! lets get you out of there so we can hold an actual conversation. heres the key" he says, almost jumping with joy

>unlock door
(with prison key)
You unlock cell door.

>open door
You open cell door.

>e
west dungeon
It is somehow even smellier here than inside your cell. it turns out that the dungeon is actually really small and plain. now that you're getting a better look, there is only one other cell besides yours. the only thing you can see is your guard looking quite happy. "what do you want to talk about, friend?" he asks almost jumping with joy. your cell is to the west, and you are in front of the other cell.

>e
(first opening your cell door)
It seems to be locked.

>x door
a set of iron bars. they aren't going to budge and there isn't enough room to squeze through.

>x cell door
a set of iron bars. they aren't going to budge and there isn't enough room to squeze through.

>n
You can't go that way.

>n
You can't go that way.

>x papers
You can't see any such thing.

>s
You can't go that way.

I beg your pardon?

>x door
a set of iron bars. they aren't going to budge and there isn't enough room to squeze through.

* * *

>x cell door
a set of iron bars. they aren't going to budge and there isn't enough room to squeze through.

>norberts door
That's not a verb I recognise.

>n
You can't go that way.

>x picture
You can't see any such thing.

>take picture
You can't see any such thing.

>e
(first opening your cell door)
It seems to be locked.

>i
You are carrying nothing.

>x picture
You can't see any such thing.

>x pictures
You can't see any such thing.

>s
You can't go that way.

>w
You can't go that way.

>x pictures
You can't see any such thing.

>smell
You smell nothing unexpected.

>e
(first opening your cell door)
It seems to be locked.

>x pictures
You can't see any such thing.

>w
You can't go that way.

>w
You can't go that way.

>n
You can't go that way.

>open cabinet
You can't see any such thing.

>close cabinet
You can't see any such thing.

I beg your pardon?

>take all
There are none at all available!

* * *

>e
west dungeon
It is somehow even smellier here than inside your cell. it turns out that the dungeon is actually really small and plain. now that you're getting a better look, there is only one other cell besides yours. the only thing you can see is your guard looking quite happy. "what do you want to talk about, friend?" he asks almost jumping with joy. your cell is to the west, and you are in front of the other cell.

>n
warden's room
what appears to be a typical office space. there is a desk piled high with papers and not much else.

* * *

>take all
bread: Taken.
cheese: Taken.
lettuce: Taken.
garlic: Taken.
peanut butter: Taken.
jelly: Taken.

>give bread to ghost
he takes your ingredient and gets back to work

>give cheese to ghost
(cheese to ghost chef)
he takes your ingredient and gets back to work
"here you go buddy" he says

>i
You are carrying:
  grilled cheese
  jelly
  peanut butter
  garlic
  lettuce
  prison key

>s
west hallway
a plain hallway connecting the prison to the rest of the castle. the kitchen is to the north and the warden's room is to the east

>e
warden's room
what appears to be a typical office space. there is a desk piled high with papers and not much else.

>s
west dungeon
It is somehow even smellier here than inside your cell. it turns out that the dungeon is actually really small and plain. now that you're getting a better look, there is only one other cell besides yours. the only thing you can see is your guard looking quite happy. "what do you want to talk about, friend?" he asks almost jumping with joy. your cell is to the west, and you are in front of the other cell.

>give grilled cheese to guard
well, even if i lose my job it's worth it now. heres the key.

>e
east dungeon
It is somehow even smellier here than inside your cell. it turns out that the dungeon is actually really small and plain. now that you're getting a better look, there is only one other cell besides yours. the only thing you can see is your guard looking quite happy. "what do you want to talk about, friend?" he asks almost jumping with joy. your cell is to the west, the other cell is to the east, and there is another nexit to the north.

>e
(first opening the other cell door)
It seems to be locked.

>unlock door
What do you want to unlock the other cell door with?

>e
You can't see any such thing.

>unlock door
What do you want to unlock the other cell door with?

>norbert's key
You unlock the other cell door.

>e
(first opening the other cell door)

norbert's cell
this cell looks exactly the same as your cell, except without scratches and your cell didn't have what looks like a dirty monkey.

>ask norbert about meat
he rolls over to show you a slab of meat. you also notice his unnaturally stumpy arm.

>take meat
Taken.

>e
You can't go that way.

>w
east dungeon
It is somehow even smellier here than inside your cell. it turns out that the dungeon is actually really small and plain. now that you're getting a better look, there is only one other cell besides yours. the only thing you can see is your guard looking quite happy. "what do you want to talk about, friend?" he asks almost jumping with joy. your cell is to the west, the other cell is to the east, and there is another nexit to the north.

>w
west dungeon
It is somehow even smellier here than inside your cell. it turns out that the dungeon is actually really small and plain. now that you're getting a better look, there is only one other cell besides yours. the only thing you can see is your guard looking quite happy. "what do you want to talk about, friend?" he asks almost jumping with joy. your cell is to the west, and you are in front of the other cell.

>n
warden's room
what appears to be a typical office space. there is a desk piled high with papers and not much else.

* * *

>n
kitchen
you can see several ghosts here, all making sandwiches. they must really like their sandwiches. there is a cabinet and several tables here as well. the hallway is to the south and the courtyard is to the east

>give bread to ghost
(first taking bread)
he takes your ingredient and gets back to work

>give meat to ghost
he takes your ingredient and gets back to work
"here you go buddy" he says. "I can add more to that if you want. just give me back the burger first, then the rest of the ingredients."

>i
You are carrying:
  hamburger
  norbert's key
  jelly
  peanut butter
  garlic
  lettuce
  prison key

>e
courtyard
a large open area in front of the throne room. you can see kobolds swinging their swords at wooden practice dummy. there is one still available if you'd like to practice too. the throne room is to the north.

>n
(first opening royal door)
woah, you have a burger!? the demon lord is going to want to see this. alright you can go in.

throne room
a massive room embelished with banners and statues. Despite the size and grandeur, the room seems rather empty. there is a huge throne on which a person who can only be the demon lord sits.

>give burger to demon lord
You can't see any such thing.

>give  hamburger to demon lord
"human, this burger is delicious. you have earned the right to one single favor. what is it you desire?" he asks

>ask about escape
You can't see any such thing.

>ask demon lord about escape
"very well. i will allow you to return home." he says

    *** The End ***

Would you like to RESTART, RESTORE a saved game, QUIT or UNDO the last command?

* * *

>unlock door
(with prison key)
You unlock cell door.

>unlock cell door
(with prison key)
That's unlocked at the moment.

>open door
You open celldoor.

>e
dungeon
It is somehow even smellier here than inside your cell. it turns out that the dungeon is actually really small and plain. now that you're getting a better look, there is only one other cell besides yours to the east of the dungeon. the only thing you can see is your guard looking quite happy. "what do you want to talk about, friend?" he asks.

>east
(first opening cell door)
It seems to be locked.

>e
(first opening cell door)
It seems to be locked.

>e
(first opening cell door)
It seems to be locked.

>attack guard
despite the fact that he literally has no muscle, he manages to subdue you and put you back in your cell.

prison cell
a dank and musty prison cell. there isn't much to do but look at the scratches on the wall and talk to the guard that's even more bored than you.

>i
You are carrying nothing.

>e
(first opening celldoor)
It seems to be locked.

* * *

>ask about sandwiches
You can't see any such thing.

>ask guard about sandwiches
I just love sandwiches, how about you?

* * *

>yes
That was a rhetorical question.

>tes
That's not a verb I recognise.

>yes
That was a rhetorical question.

* * *

>ask guard about cheese burger
he doesn't seem comfortable talking about that. you should try changing the subject.

>ask guard about grilled cheese
I just love grilled cheese, how about you?

* * *

>yes
"even better than a fellow sandwich lover, a fellow grilled cheese lover! lets get you out of there so we can hold an actual conversation. heres the key" he says, almost jumping with joy

>e
(first opening your cell door)
It seems to be locked.

>unlock door
(with prison key)
You unlock your cell door.

>e
(first opening your cell door)

dungeon
It is somehow even smellier here than inside your cell. it turns out that the dungeon is actually really small and plain. now that you're getting a better look, there is only one other cell besides yours. the only thing you can see is your guard looking quite happy. "what do you want to talk about, friend?" he asks almost jumping with joy. your cell is to the west, the other cell is to the east, and there is another exit to the north.

>ask guard for norbert's key
"okay, here's the key" he says

>unlock other door
What do you want to unlock your cell door with?

>norbert's key
That's unlocked at the moment.

>e
(first opening the other cell door)
It seems to be locked.

>unlock other cell door
What do you want to unlock your cell door with?

>unlock norbert's door
What do you want to unlock the other cell door with?

* * *

>norbert's key
You unlock the other cell door.

>open cell door
Which do you mean, your cell door or the other cell door?

>other cell door
(your cell door)
That's already open.

>e
(first opening the other cell door)

norbert's cell
this cell looks exactly the same as your cell, except without scratches and your cell didn't have what looks like a dirty monkey.

* * *

>ask norbert about burgers
he rolls over to show you a burger patty

>take
(the other cell door)
That's hardly portable.

>take all
There are none at all available!

>take burger
You can't see any such thing.

>take burger patty
You can't see any such thing.

* * *

>ask guard about grilled cheese
I just love grilled cheese, how about you?

* * *

>yes
"even better than a fellow sandwich lover, a fellow grilled cheese lover! lets get you out of there so we can hold an actual conversation. heres the key" he says, almost jumping with joy

>e
(first opening cell door)
It seems to be locked.

>unlock door
(with prison key)
You unlock cell door.

>e
(first opening cell door)

west dungeon
It is somehow even smellier here than inside your cell. it turns out that the dungeon is actually really small and plain. now that you're getting a better look, there is only one other cell besides yours. the only thing you can see is your guard looking quite happy. "what do you want to talk about, friend?" he asks almost jumping with joy. your cell is to the west, and you are in front of the other cell.

>n
warden's room
what appears to be a typical office space. there is a desk piled high with papers and not much else.

* * *

>w
west hallway
a plain hallway connecting the prison to the rest of the castle. the kitchen is to the north and the warden's room is to the east

>e
warden's room
what appears to be a typical office space. there is a desk piled high with papers and not much else.

* * *

>s
west dungeon
It is somehow even smellier here than inside your cell. it turns out that the dungeon is actually really small and plain. now that you're getting a better look, there is only one other cell besides yours. the only thing you can see is your guard looking quite happy. "what do you want to talk about, friend?" he asks almost jumping with joy. your cell is to the west, and you are in front of the other cell.

>ask guard for key
"i'm not sure how i feel about this, even for a friend. i could lose my job you know"

>n
warden's room
what appears to be a typical office space. there is a desk piled high with papers and not much else.

* * *

>i
You are carrying:
  norbert's key
  grilled cheese
  jelly
  peanut butter
  garlic
  lettuce
  prison key

>n
warden's room
what appears to be a typical office space. there is a desk piled high with papers and not much else.

>x papers
looking through the reports, you notice that most of the people being held in the dungeon were eventually going to be used as filling for a sandwich and eaten. you were going to be used the same way, but there was someone else who was going to be used first. his name is norbert and he is still in the other cell.

>i
You are carrying:
  norbert's key
  grilled cheese
  jelly
  peanut butter
  garlic
  lettuce
  prison key

>n
You can't go that way.

>w
west hallway
a plain hallway connecting the prison to the rest of the castle. the kitchen is to the north and the warden's room is to the east

* * *

>n
kitchen
you can see several ghosts here, all making sandwiches. they must really like their sandwiches. there is a cabinet and several tables here as well. the hallway is to the south and the courtyard is to the east

>take all
cheese: Taken.
bread: Taken.

>give bread to ghost
he takes your ingredient and gets back to work

>give cheese to ghost
Which do you mean, cheese, grilled cheese or cheese burger?

>i
You are carrying:
  cheese
  norbert's key
  grilled cheese
  jelly
  peanut butter
  garlic
  lettuce
  prison key

>s
west hallway
a plain hallway connecting the prison to the rest of the castle. the kitchen is to the north and the warden's room is to the east

* * *

>s
west dungeon
It is somehow even smellier here than inside your cell. it turns out that the dungeon is actually really small and plain. now that you're getting a better look, there is only one other cell besides yours. the only thing you can see is your guard looking quite happy. "what do you want to talk about, friend?" he asks almost jumping with joy. your cell is to the west, and you are in front of the other cell.

>e
east dungeon
It is somehow even smellier here than inside your cell. it turns out that the dungeon is actually really small and plain. now that you're getting a better look, there is only one other cell besides yours. the only thing you can see is your guard looking quite happy. "what do you want to talk about, friend?" he asks almost jumping with joy. your cell is to the west, the other cell is to the east, and there is another nexit to the north.

>give grilled cheese to guard
well, even if i lose my job it's worth it now. heres the key.

>i
You are carrying:
  norbert's key
  cheese
  jelly
  peanut butter
  garlic
  lettuce
  prison key

>e
(first opening norbert's cell door)
It seems to be locked.

>unlock norbert's door
What do you want to unlock norbert's cell door with?

>norbert's key
You unlock norbert's cell door.

>e
(first opening norbert's cell door)

norbert's cell
this cell looks exactly the same as your cell, except without scratches and your cell didn't have what looks like a dirty monkey.

>ask norbert about meat
he rolls over to show you a slab of meat. you also notice his unnaturally stumpy arm.

* * *

>w
east dungeon
It is somehow even smellier here than inside your cell. it turns out that the dungeon is actually really small and plain. now that you're getting a better look, there is only one other cell besides yours. the only thing you can see is your guard looking quite happy. "what do you want to talk about, friend?" he asks almost jumping with joy. your cell is to the west, the other cell is to the east, and there is another nexit to the north.

>n
You can't go that way.

>w
west dungeon
It is somehow even smellier here than inside your cell. it turns out that the dungeon is actually really small and plain. now that you're getting a better look, there is only one other cell besides yours. the only thing you can see is your guard looking quite happy. "what do you want to talk about, friend?" he asks almost jumping with joy. your cell is to the west, and you are in front of the other cell.

* * *

>n
kitchen
you can see several ghosts here, all making sandwiches. they must really like their sandwiches. there is a cabinet and several tables here as well. the hallway is to the south and the courtyard is to the east

>i
You are carrying:
  meat
  norbert's key
  cheese
  jelly
  peanut butter
  garlic
  lettuce
  prison key

>take bread
That seems to belong to ghost chef.

>s
west hallway
a plain hallway connecting the prison to the rest of the castle. the kitchen is to the north and the warden's room is to the east

* * *

>i
You are carrying:
  prison key

>ask guard about guard
"i'm just your normal skelleton hired by the demon lord for some extra manpower." he says

>ask guard about t
he doesn't seem comfortable talking about that. you should try changing the subject.

>unlock door
(with prison key)
You unlock your cell door.

* * *

>e
dungeon
It is somehow even smellier here than inside your cell. it turns out that the dungeon is actually really small and plain. now that you're getting a better look, there is only one other cell besides yours. the only thing you can see is your guard looking quite happy. "what do you want to talk about, friend?" he asks almost jumping with joy. your cell is to the west, the other cell is to the east, and there is another exit to the north.

>ask guard about t
he doesn't seem comfortable talking about that. you should try changing the subject.

>ask guard about guard
"i'm just your normal skelleton hired by the demon lord for some extra manpower." he says

>talk to guard
I only understood you as far as wanting to talk.

>talki to guard
That's not a verb I recognise.

>talk to guard
I only understood you as far as wanting to talk.

>talking guard
That's not a verb I recognise.

>talk guard
I only understood you as far as wanting to talk.

* * *

>yes
"even better than a fellow sandwich lover, a fellow grilled cheese lover! lets get you out of there so we can hold an actual conversation. heres the key" he says, almost jumping with joy

>unloc door
That's not a verb I recognise.

>x door
You can't see any such thing.

>unlock cell door
(with prison key)
You unlock cell door.

>open cell door
You open cell door.

>e
west dungeon
It is somehow even smellier here than inside your cell. it turns out that the dungeon is actually really small and plain. now that you're getting a better look, there is only one other cell besides yours. the only thing you can see is your guard looking quite happy. "what do you want to talk about, friend?" he asks almost jumping with joy. your cell is to the west, the other cell is to the east, and there is another nexit to the north.

>x door
You can't see any such thing.

>x other door
You can't see any such thing.

>x other cell door
a set of iron bars. they aren't going to budge and there isn't enough room to squeze through.

* * *

>give cheese to ghost
(cheese to ghost chef)
he takes your ingredient and gets back to work
"here you go buddy" he says

>take bread
Taken.

>i
You are carrying:
  bread
  grilled cheese
  jelly
  peanut butter
  garlic
  lettuce
  prison key

>s
west hallway
a plain hallway connecting the prison to the rest of the castle. the kitchen is to the north and the warden's room is to the east

* * *

>s
west dungeon
It is somehow even smellier here than inside your cell. it turns out that the dungeon is actually really small and plain. now that you're getting a better look, there is only one other cell besides yours. the only thing you can see is your guard looking quite happy. "what do you want to talk about, friend?" he asks almost jumping with joy. your cell is to the west, and you are in front of the other cell.

>s
You can't go that way.

>give grilled cheese to guard
well, even if i lose my job it's worth it now. heres the key.

I beg your pardon?

>i
You are carrying:
  norbert's key
  bread
  jelly
  peanut butter
  garlic
  lettuce
  prison key

>e
east dungeon
It is somehow even smellier here than inside your cell. it turns out that the dungeon is actually really small and plain. now that you're getting a better look, there is only one other cell besides yours. the only thing you can see is your guard looking quite happy. "what do you want to talk about, friend?" he asks almost jumping with joy. your cell is to the west, the other cell is to the east, and there is another nexit to the north.

>unlock door
What do you want to unlock the other cell door with?

* * *

>ask norbert about meat
he rolls over to show you a slab of meat. you also notice his unnaturally stumpy arm.

>take
(the other cell door)
That's hardly portable.

>take meat
Taken.

* * *

>n
kitchen
you can see several ghosts here, all making sandwiches. they must really like their sandwiches. there is a cabinet and several tables here as well. the hallway is to the south and the courtyard is to the east

>take cheese
Which do you mean, cheese, grilled cheese or cheese burger?

>give ghost bread
he takes your ingredient and gets back to work

>give ghost mear
You can't see any such thing.

>give ghost meat
he takes your ingredient and gets back to work
"here you go buddy" he says. "I can add more to that if you want. just give me back the burger first, then the rest of the ingredients."

>i
You are carrying:
  hamburger
  norbert's key
  jelly
  peanut butter
  garlic
  lettuce
  prison key

* * *

>n
(first opening royal door)
woah, you have a burger!? the demon lord is going to want to see this. alright you can go in.

throne room
a massive room embelished with banners and statues. Despite the size and grandeur, the room seems rather empty. there is a huge throne on which a person who can only be the demon lord sits.

>i
You are carrying:
  hamburger
  norbert's key
  jelly
  peanut butter
  garlic
  lettuce
  prison key

>s
courtyard
a large open area in front of the throne room. you can see kobolds swinging their swords at wooden practice dummy. there is one still available if you'd like to practice too. the throne room is to the north.

>drop hamburger
Dropped.

>n
throne room
a massive room embelished with banners and statues. Despite the size and grandeur, the room seems rather empty. there is a huge throne on which a person who can only be the demon lord sits.

>s
courtyard
a large open area in front of the throne room. you can see kobolds swinging their swords at wooden practice dummy. there is one still available if you'd like to practice too. the throne room is to the north.

You can see hamburger here.

>close royal door
You close royal door.

>n
(first opening royal door)
you are stopped by the two guards. "the demon lords a busy guy. you can't go in unless it's really important.

>take hamburger
Taken.

>n
(first opening royal door)
woah, you have a burger!? the demon lord is going to want to see this. alright you can go in.

throne room
a massive room embelished with banners and statues. Despite the size and grandeur, the room seems rather empty. there is a huge throne on which a person who can only be the demon lord sits.

>give hamburger to demon lord
"human, this burger is delicious. you have earned the right to one single favor. what is it you desire?" he asks

>ask about escape
You can't see any such thing.

* * *

>ask demon lord about escape
"very well. i will allow you to return home." he says

    *** The End ***

Would you like to RESTART, RESTORE a saved game, QUIT or UNDO the last command?

>undo
throne room
[Previous turn undone.]

I beg your pardon?

>undo
throne room
[Previous turn undone.]

>ask demon lord about escap
as you try to approach the throne the demon lord shoots you a nasty glare. you choose to back away

>ask demon lord about esccape
as you try to approach the throne the demon lord shoots you a nasty glare. you choose to back away

* * *

>n
kitchen
you can see several ghosts here, all making sandwiches. they must really like their sandwiches. there is a cabinet and several tables here as well. the hallway is to the south and the courtyard is to the east

I beg your pardon?

>open cabinet
You open cabinet, revealing bread, cheese, lettuce, garlic, peanut butter and jelly.

>i
You are carrying:
  prison key

>take all
bread: Taken.
cheese: Taken.
lettuce: Taken.
garlic: Taken.
peanut butter: Taken.
jelly: Taken.

* * *

>give bread to ghost chef
he takes your ingredient and gets back to work

>i
You are carrying:
  jelly
  peanut butter
  garlic
  lettuce
  cheese
  prison key

>give cheese to ghost
(cheese to ghost chef)
he takes your ingredient and gets back to work
"here you go buddy" he says

>i
You are carrying:
  grilled cheese
  jelly
  peanut butter
  garlic
  lettuce
  prison key

"here you go buddy" he says

* * *

>unlock door
(with prison key)
You unlock cell door.

>x door
You can't see any such thing.

>x your cell door
You can't see any such thing.

>x cell
You can't see any such thing.

>open door
You can't see any such thing.

>e
(first opening door)
It seems to be locked.

>x door
You can't see any such thing.

* * *

>x other door
You can't see any such thing.

>x norbert's door
You can't see any such thing.

>ask guard for key
You can't see any such thing.

>i
You are carrying:
  prison key

>x norbert's door
You can't see any such thing.

>x other door
You can't see any such thing.

>n
You can't go that way.

* * *

>x papers
You can't see any such thing.

>x
(prison key)
You see nothing special about prison key.

>s
You can't go that way.

>s
You can't go that way.

>x door
You can't see any such thing.

>x other cell door
a set of iron bars. they aren't going to budge and there isn't enough room to squeze through.

* * *

>ask guard about grilled chese
he doesn't seem comfortable talking about that. you should try changing the subject.

>yes
That was a rhetorical question.

>ask guard about grilled cheese
I just love grilled cheese, how about you?

* * *

>yes
"even better than a fellow sandwich lover, a fellow grilled cheese lover! lets get you out of there so we can hold an actual conversation. heres the key" he says, almost jumping with joy

>unlock door
You can't see any such thing.

>open door
You can't see any such thing.

* * *

>e
(first opening door)
It seems to be locked.

>ask guard for norbert's key
You can't see any such thing.

>unlock other cell door
(with prison key)
You unlock door.

>unlock other cell
(with prison key)
That's unlocked at the moment.

>w
You can't go that way.

* * *

>x door
You can't see any such thing.

>unlock norbert's door
You can't see any such thing.

>norbert's key
That's not a verb I recognise.

>e
(first opening door)

dungeon
It is somehow even smellier here than inside your cell. it turns out that the dungeon is actually really small and plain. now that you're getting a better look, there is only one other cell besides yours. the only thing you can see is your guard looking quite happy. "what do you want to talk about, friend?" he asks almost jumping with joy. your cell is to the west, the other cell is to the east, and there is another exit to the north.

>ask norbert about burgers
You can't see any such thing.

>take
(prison key)
You already have that.

>take burger
You can't see any such thing.

>e
(first opening the other cell door)
It seems to be locked.

>s
You can't go that way.

>w
prison cell
a dank and musty prison cell. there isn't much to do but look at the scratches on the wall and talk to the guard that's even more bored than you. the rest of the dungeon is to the east

>b
That's not a verb I recognise.

>n
You can't go that way.

>w
You can't go that way.

* * *

>open cabinet
You can't see any such thing.

>take all
There are none at all available!

>give burger to ghost chef
You can't see any such thing.

>give bread to ghost chef
You can't see any such thing.

>ask ghost chef for hamburger
You can't see any such thing.

>ask ghost chef for burger
You can't see any such thing.

>ask ghost chef for hamburger
You can't see any such thing.

>i
You are carrying:
  prison key

>ask ghost chef for hamburger
You can't see any such thing.

>ask ghost chef about hamburger
You can't see any such thing.

>i
You are carrying:
  prison key

>e
dungeon
It is somehow even smellier here than inside your cell. it turns out that the dungeon is actually really small and plain. now that you're getting a better look, there is only one other cell besides yours. the only thing you can see is your guard looking quite happy. "what do you want to talk about, friend?" he asks almost jumping with joy. your cell is to the west, the other cell is to the east, and there is another exit to the north.

* * *

>ask guard about l
he doesn't seem comfortable talking about that. you should try changing the subject.

>attack guard
you can't reach him from within your cell.

>ask guard about grilled cheese
I just love grilled cheese, how about you?

>ask guard about to
Please answer yes or no.

>ask guard about guard
Please answer yes or no.

>ask guard about grilled cheese
Please answer yes or no.

>ask guard about cell
Please answer yes or no.

>ask guard about sandwiches
Please answer yes or no.

>ask guard about scratches
Please answer yes or no.

>yes
"even better than a fellow sandwich lover, a fellow grilled cheese lover! lets get you out of there so we can hold an actual conversation. heres the key" he says, almost jumping with joy

* * *

>ask guard about sandwiches
I just love sandwiches, how about you?

* * *

>yes
it's so good to meet a fellow sandwich lover. my favorite is grilled cheese.

I beg your pardon?

>yes
That was a rhetorical question.

>yes
That was a rhetorical question.

>ask about grilled cheese
You can't see any such thing.

* * *

>ask guard about grilled cheese
I just love grilled cheese, how about you?

>yes
even better than a fellow sandwich lover, a fellow grilled cheese lover! lets get you out of there so we can hold an actual conversation.

* * *

>yes
it's so good to meet a fellow sandwich lover. my favorite is grilled cheese.

>ask guard about grilled cheese
I just love grilled cheese, how about you?

* * *

>e
west dungeon
It is somehow even smellier here than inside your cell. it turns out that the dungeon is actually really small and plain. now that you're getting a better look, there is only one other cell besides yours. the only thing you can see is your guard looking quite happy. "what do you want to talk about, friend?" he asks almost jumping with joy. your cell is to the west, and you are in front of the other cell.

>e
east dungeon
It is somehow even smellier here than inside your cell. it turns out that the dungeon is actually really small and plain. now that you're getting a better look, there is only one other cell besides yours. the only thing you can see is your guard looking quite happy. "what do you want to talk about, friend?" he asks almost jumping with joy. your cell is to the west, the other cell is to the east, and there is another nexit to the north.

>x door
a set of iron bars. they aren't going to budge and there isn't enough room to squeze through. you can make out the vauge outline of someone, but he seems to be sleeping.

>n
You can't go that way.

* * *

>give bread to ghost
he takes your ingredient and gets back to work

>x ghost
a spectral chef. similar to how the skelletons somehow move without muscle, he inexpilcably makes sandwiches without physicalf form.

>ask ghost about grilled cheese
"only that lonely guard actually likes grilled cheese. peanut butter and jelly sandwiches are the best." he responds

>give bread to ghost chef
(first taking bread)
That seems to belong to ghost chef.

>give cheese to ghost chef
(cheese to ghost chef)
he takes your ingredient and gets back to work

>ask ghost chef for grilled cheese
"here you go buddy" he says

>i
You are carrying:
  burger
  grilled cheese
  jelly
  peanut butter
  garlic
  lettuce
  prison key

* * *

>attack guard
You can't see any such thing.

>attack guard
You can't see any such thing.

>hit guard
You can't see any such thing.

>take guard
You can't see any such thing.

* * *

>e
You can't go that way.

>n
warden's room

>n
You can't go that way.

>e
east hallway

>n
armory

>n
You can't go that way.

>e
You can't go that way.

>w
courtyard

>w
kitchen

>e
courtyard

>e
armory

>s
east hallway

>w
warden's room

>e
east hallway

>e
You can't go that way.

>w
warden's room

>w
You can't go that way.

>e
east hallway

>w
warden's room

* * *

>n
warden's room

>w
You can't go that way.

I beg your pardon?

* * *

>e
You can't go that way.

>x celldoor
a set of iron bars. they aren't going to budge and there isn't enough room to squeze through.

>x cell door
a set of iron bars. they aren't going to budge and there isn't enough room to squeze through.

* * *

>i
You are carrying nothing.

>ask guard about grilled chees
he doesn't seem comfortable talking about that. you should try changing the subject.

>ask guard about grilled cheese
I just love grilled cheese, how about you?

* * *

>n
warden's room
what appears to be a typical office space. there is a desk piled high with papers and not much else.

>n
You can't go that way.

* * *

>n
kitchen
you can see several ghosts here, all making sandwiches. they must really like their sandwiches. there is a cabinet and several tables here as well. the hallway is to the south and the courtyard is to the east

>i
You are carrying:
  prison key

>open cabinet
You open cabinet, revealing bread, cheese, lettuce, garlic, peanut butter and jelly.

* * *

>give cheese to ghost
(cheese to ghost chef)
he takes your ingredient and gets back to work
"here you go buddy" he says

>i
You are carrying:
  cheese burger
  grilled cheese
  jelly
  peanut butter
  garlic
  lettuce
  prison key

"here you go buddy" he says

* * *

>n
You can't go that way.

>e
dungeon

>n
warden's room

>w
west hallway

>n
kitchen

>e
courtyard

* * *

>w
warden's room

>w
west hallway

* * *

>switch guard on
that isn't something you can do that to

* * *

>talk to guard
he seems bad at holding conversations. you should try asking about something he might be interested in to get the conversation going

>ask about grilled cheese
You can't see any such thing.

* * *

>yes
"even better than a fellow sandwich lover, a fellow grilled cheese lover! lets get you out of there so we can hold an actual conversation. heres the key" he says, almost jumping with joy

>unlock door
(with prison key)
You unlock your cell door.

* * *

>open door
You open your cell door.

>n
You can't go that way.

>e
dungeon
It is somehow even smellier here than inside your cell. it turns out that the dungeon is actually really small and plain. now that you're getting a better look, there is only one other cell besides yours. the only thing you can see is your guard looking quite happy. "what do you want to talk about, friend?" he asks almost jumping with joy. your cell is to the west, the other cell is to the east, and there is another exit to the north.

* * *

>n
armory
The place where the monsters store their weapons. you can see an assortment of swords, spears, and axes. the courtyard is to the west.

>w
courtyard
a large open area in front of the throne room. you can see kobolds swinging their swords at wooden practice dummy. there is one still available if you'd like to practice too. the throne room is to the north.

>e
armory
The place where the monsters store their weapons. you can see an assortment of swords, spears, and axes. the courtyard is to the west.

>take
(prison key)
You already have that.

>take spear
Taken.

>w
courtyard
a large open area in front of the throne room. you can see kobolds swinging their swords at wooden practice dummy. there is one still available if you'd like to practice too. the throne room is to the north.

>give skelleton spear
You can't see any such thing.

>n
You can't go that way.

>w
kitchen
you can see several ghosts here, all making sandwiches. they must really like their sandwiches. there is a cabinet and several tables here as well. the hallway is to the south and the courtyard is to the east

>ask ghost chef for burger
Ghost chef has better things to do.

>i
You are carrying:
  spear
  prison key

* * *

>talk to guard
he seems bad at holding conversations. you should try asking about something he might be interested in to get the conversation going

>ask about guard
You can't see any such thing.

>ask guard
What do you want to ask guard1 for?

* * *

>talk to guard
he seems bad at holding conversations. you should try asking about something he might be interested in to get the conversation going

>talk guard
I didn't understand that sentence.

* * *

>talk to guard
he seems bad at holding conversations. you should try asking about something he might be interested in to get the conversation going

>talk gurd
I only understood you as far as wanting to talk.

>talk guard
I only understood you as far as wanting to talk.

* * *

>talk to guard
he seems bad at holding conversations. you should try asking about something he might be interested in to get the conversation going

>talk to guard1
I didn't understand that sentence.

>talking guard
That's not a verb I recognise.

>talk guard
I didn't understand that sentence.

>talk to guard
I didn't understand that sentence.

* * *

>talk to guard about grilled cheese
I only understood you as far as wanting to talk to the guard.

>talk to guard about grilled cheese
I only understood you as far as wanting to talk to the guard.

>ask guard about grilled cheese
I just love grilled cheese, how about you?

* * *

>give grilled cheese to guard
well, even if i lose my job it's worth it now. heres the key.

>i
You are carrying:
  jelly
  peanut butter
  garlic
  lettuce
  prison key

>e
east dungeon
It is somehow even smellier here than inside your cell. it turns out that the dungeon is actually really small and plain. now that you're getting a better look, there is only one other cell besides yours. the only thing you can see is your guard looking quite happy. "what do you want to talk about, friend?" he asks almost jumping with joy. your cell is to the west, the other cell is to the east, and there is another nexit to the north.

>unlock norbert's door
What do you want to unlock the other cell door with?

>prison key
You can't see any such thing.

>reset
That's not a verb I recognise.

* * *

>talk to guard1
I only understood you as far as wanting to talk.

>talk to guard
I only understood you as far as wanting to talk.

>talk guard
I only understood you as far as wanting to talk.

>speak guard
(to the guard)
There is no reply.

>ask about grilled cheese
You can't see any such thing.

* * *

>unlock door
(with prison key)
You unlock your cell door.

>open dor
You can't see any such thing.

>open door
You open your cell door.

>ask about grilled cheese
You can't see any such thing.

>ask guard about grilles cheese
he doesn't seem comfortable talking about that. you should try changing the subject.

>ask guard about grilled cheese
I just love grilled cheese, how about you?

>to
Please answer yes or no.

>no
he goes quiet. you can see him sulking in the corner of the dungeon

>no
That was a rhetorical question.

>ask guard about grilled cheese
I just love grilled cheese, how about you?

>no
he goes quiet. you can see him sulking in the corner of the dungeon

>ask about sandwich
You can't see any such thing.

>ask guard about sandwich
I just love sandwiches, how about you?

>no
he goes quiet. you can see him sulking in the corner of the dungeon

>ask about grilled cheese
You can't see any such thing.

* * *

>yes
"even better than a fellow sandwich lover, a fellow grilled cheese lover! lets get you out of there so we can hold an actual conversation. heres the key" he says, almost jumping with joy

>open door
That's already open.

>e
dungeon
It is somehow even smellier here than inside your cell. it turns out that the dungeon is actually really small and plain. now that you're getting a better look, there is only one other cell besides yours. the only thing you can see is your guard looking quite happy. "what do you want to talk about, friend?" he asks almost jumping with joy. your cell is to the west, the other cell is to the east, and there is another exit to the north.

* * *

>e
east hallway
a plain hallway adorned with pictures connecting the prison to the rest of the castle. the armory is to the north and the warden's room is to the west

>n
armory

>w
courtyard
a large open area in front of the throne room. you can see skelletons swinging their swords at wooden practice dummy. there is one still available if you'd like to practice too.

>w
kitchen
you can see several skelletons here, all making sandwiches. they must really like their sandwiches. there is a cabinet and several tables here as well. the hallway is to the south and the courtyard is to the east

>talk to skelleton chef
I only understood you as far as wanting to talk.

>talk skelleton chef
I only understood you as far as wanting to talk.

>talking skelleton chef
That's not a verb I recognise.

>swing key
You can't see any such thing.

>i
You are carrying:
  prison key

>swing prison key
You can't see any such thing.

>take chef
he doesn't seem willing to go with you.

>talk to skelleton chef
I only understood you as far as wanting to talk.

>talk to chef
I only understood you as far as wanting to talk.

* * *

>x door
You can't see any such thing.

* * *

>x guard
Your guard appears to be a skelleton. you can't actually tell if it can see with out eyes. or move without muscles.

>ask about guard
You can't see any such thing.

>ask guard
What do you want to ask guard for?

>ask about guard
You can't see any such thing.

>ask guard about guard
i'm just your normal skelleton hired by the demon lord for some extra manpower.

* * *

>x guard
Your guard appears to be a skelleton. you can't actually tell if it can see with out eyes. or move without muscles.

>attack guard
you can't reach him from within your cell.

>x scratches
you can barely make out the word "he loves sandwiches"

* * *

>x musty
You can't see any such thing.

>x scratches
Among the many gashes in the wall you can barely make out the words "He loves sandwiches"

>x sandwiches
You can't see any such thing.

>x guard
Your guard appears to be a skeleton. You can't actually tell if it can see without eyes. Or move without muscles. What you can tell is that he has the key you need to get out.

>talk to guard
He seems bad at holding conversations. You should try asking about something he might be interested in to get the conversation going

>ask guard about dungeon
He doesn't seem comfortable talking about that. You should try changing the subject.

>ask guard about sandwhiches
He doesn't seem comfortable talking about that. You should try changing the subject.

>ask guard about sandwhich
He doesn't seem comfortable talking about that. You should try changing the subject.

>ask guard about weather
"It's been sunny lately. No sign that it's going to change either." He says

>ask guard about sandwich
I just love sandwiches, how about you?

>yes
"It's so good to meet a fellow sandwich lover. My favorite is grilled cheese." he says, he is noticeably happier.

>ask guard about grilled cheese
I just love grilled cheese, how about you?

>yes
"Even better than a fellow sandwich lover, a fellow grilled cheese lover! Lets get you out of there so we can hold an actual conversation. Here's the key" he says, almost jumping with joy

>unlock door
(with prison key)
You unlock cell door.

>e
(first opening cell door)

west dungeon
It is somehow even smellier here than inside your cell. It turns out that the dungeon is actually really small and plain. Now that you're getting a better look, there is only one other cell besides yours. The only thing you can see is your guard looking quite happy. "What do you want to talk about, friend?" he asks almost jumping with joy. Your cell is to the west, and you are in front of the other cell.

>n
warden's room
What appears to be a typical office space. The walls are made out of wood and painted a light brown. It's almost as if it isn't connected to the dungeon. there is a desk piled high with papers and not much else.

>w
west hallway
A hallway connecting the prison to the rest of the castle. There is a red carpet floor and yellow walls. The kitchen is to the north and the warden's room is to the east

>n
kitchen
You can see several ghosts here, all making sandwiches. they must really like their sandwiches. There is a cabinet and several tables here as well. the hallway is to the south and the courtyard is to the east

>open cabinet
You open cabinet, revealing bread, cheese, garlic, peanut butter and jelly.

>take all
bread: Taken.
cheese: Taken.
garlic: Taken.
peanut butter: Taken.
jelly: Taken.

>give bread to ghost chef
He takes your ingredient and gets back to work

>give cheese to ghost chef
(cheese to ghost chef)
He takes your ingredient and gets back to work
"Here's your grilled cheese buddy" he says

>s
west hallway
A hallway connecting the prison to the rest of the castle. There is a red carpet floor and yellow walls. The kitchen is to the north and the warden's room is to the east

>e
warden's room
What appears to be a typical office space. The walls are made out of wood and painted a light brown. It's almost as if it isn't connected to the dungeon. there is a desk piled high with papers and not much else.

>s
west dungeon
It is somehow even smellier here than inside your cell. It turns out that the dungeon is actually really small and plain. Now that you're getting a better look, there is only one other cell besides yours. The only thing you can see is your guard looking quite happy. "What do you want to talk about, friend?" he asks almost jumping with joy. Your cell is to the west, and you are in front of the other cell.

>give grilled cheese to guard
Well, even if i lose my job it's worth it now. here's the key.

>e
east dungeon
It is somehow even smellier here than inside your cell. It turns out that the dungeon is actually really small and plain. Now that you're getting a better look, there is only one other cell besides yours. the only thing you can see is your guard looking quite happy. "What do you want to talk about, friend?" He asks almost jumping with joy. Your cell is to the west, the other cell is to the east, and there is another nexit to the north.

>unlock door
What do you want to unlock the other cell door with?

>norbert;s key
You can't see any such thing.

>norbert's key
That's not a verb I recognise.

>e
(first opening the other cell door)
It seems to be locked.

* * *

>norbert's key
You unlock the other cell door.

>e
(first opening the other cell door)

norbert's cell
This cell looks exactly the same as your cell, except without scratches and your cell didn't have what looks like a dirty monkey.

>ask norbert about meat
He rolls over to show you a slab of meat. you also notice his unnaturally stumpy arm.

>take
(the other cell door)
That's hardly portable.

* * *

>take meat
Taken.

>w
east dungeon
It is somehow even smellier here than inside your cell. It turns out that the dungeon is actually really small and plain. Now that you're getting a better look, there is only one other cell besides yours. the only thing you can see is your guard looking quite happy. "What do you want to talk about, friend?" He asks almost jumping with joy. Your cell is to the west, the other cell is to the east, and there is another nexit to the north.

>w
west dungeon
It is somehow even smellier here than inside your cell. It turns out that the dungeon is actually really small and plain. Now that you're getting a better look, there is only one other cell besides yours. The only thing you can see is your guard looking quite happy. "What do you want to talk about, friend?" he asks almost jumping with joy. Your cell is to the west, and you are in front of the other cell.

>n
warden's room
What appears to be a typical office space. The walls are made out of wood and painted a light brown. It's almost as if it isn't connected to the dungeon. there is a desk piled high with papers and not much else.

>n
You can't go that way.

>w
west hallway
A hallway connecting the prison to the rest of the castle. There is a red carpet floor and yellow walls. The kitchen is to the north and the warden's room is to the east

* * *

>n
kitchen
You can see several ghosts here, all making sandwiches. they must really like their sandwiches. There is a cabinet and several tables here as well. the hallway is to the south and the courtyard is to the east

>take all
cheese: Taken.
bread: Taken.
grilled cheese: That seems to belong to ghost chef.

>give bread to ghost
He takes your ingredient and gets back to work

>give meat to ghost
He takes your ingredient and gets back to work
"Here's your burger buddy" He says. "I can add more to that if you want. just give me back the burger first, then the rest of the ingredients."

>e
courtyard
A large open area in front of the throne room. you can see kobolds swinging their swords at wooden practice dummy. There is one still available if you'd like to practice too. The throne room is to the north.

>n
(first opening royal door)
Whoa, you have a burger!? Yhe demon lord is going to want to see this. Alright you can go in.

throne room
A massive room embellished with banners and statues. Despite the size and grandeur, the room seems rather empty. There is a huge throne on which a person who can only be the demon lord sits.

>give hamburger to demon lord
"Human, this burger is delicious. You have earned the right to one single favor. What is it you desire?" he asks

>undo
throne room
[Previous turn undone.]

>ask about teleportation
You can't see any such thing.

>ask demon lord about teleportation
As you try to approach the throne the demon lord shoots you a nasty glare. You choose to back away

>ask demon lord about leaving
As you try to approach the throne the demon lord shoots you a nasty glare. You choose to back away

>give hamburger to demon lord
"Human, this burger is delicious. You have earned the right to one single favor. What is it you desire?" he asks

>ask demon lord about leaving
"Very well. i will allow you to return home." He says. You begin to glow and you feel yourself being lifted off your feet. Before you know it you're standing in front of your home.

    *** The End ***

Would you like to RESTART, RESTORE a saved game, QUIT or UNDO the last command?

* * *

>x scratches
You see nothing special about scratches.

>x guard
You can't see any such thing.

>x guard1
You can't see any such thing.

>x guard1
You can't see any such thing.